умный — глупый;
день — ночь;
радушно — неприязненно;
восход — закат;
добро — зло;
утро — вечер;
мир — война;
огонь — вода;
труженик — бездельник;
лето — зима;
друг — враг;
грусть — радость;
болтун — молчун;
храбрость — трусость;
грязный — чистый;
смелый — трусливый;
громкий — тихий;
широкий — узкий;
толстый — тонкий;
длинный — короткий;
сильный — слабый;
высокий — низкий;
женственный — мужественный;
светлый — темный;
далекий — близкий;
молчать — говорить;
бежать — стоять;
радоваться — огорчаться;
стемнело — рассвело;
ругать — хвалить;
взять — отдать;
построить — поломать;
защитить — обидеть;
вымокнуть — высохнуть;
зимой — летом;
утром — вечером;
пешком — бегом;
интересно — скучно;
рано — поздно;
впереди — позади;
всегда — никогда;
тут — там;
глубоко — мелко;